uid,key1_hold_dur,key2_hold_dur,DD_dur,UU_dur,UD_dur
1,88,144,264,320,176
1,88,63,129,104,41
1,64,88,64,88,0
1,88,72,224,208,136
1,80,104,312,336,232
1,72,105,88,121,16
1,72,80,120,128,48
1,72,88,72,88,0
0,72,72,176,176,104
0,72,64,176,168,104
0,72,56,192,176,120
0,72,24,232,184,160
0,72,64,192,184,120
0,72,72,168,168,96
0,71,64,192,185,121
0,80,72,184,176,104
0,97,63,161,127,64
0,88,96,72,80,-16
0,80,105,80,105,0
0,80,64,968,952,888
0,80,80,96,96,16
0,80,88,40,48,-40
0,64,80,64,80,0
0,104,88,64,48,-40
