uid,key1_hold_dur,key2_hold_dur,DD_dur,UU_dur,UD_dur
1,64,80,168,184,104
1,80,64,200,184,120
1,69,96,152,179,83
1,64,72,176,184,112
1,64,72,176,184,112
1,56,64,176,184,120
1,72,88,176,192,104
1,63,89,159,185,96
1,72,88,192,208,120
0,66,48,119,101,53
0,63,80,103,120,40
0,65,56,120,111,55
0,56,64,88,96,32
0,71,56,120,105,49
0,64,49,112,97,48
0,64,56,112,104,48
0,56,64,104,112,48
0,73,73,112,112,39
0,97,63,161,127,64
0,88,96,72,80,-16
0,80,105,80,105,0
0,80,64,968,952,888
0,80,80,96,96,16
0,80,88,40,48,-40
0,64,80,64,80,0
0,104,88,64,48,-40
0,80,80,120,120,40
