uid,key1_hold_dur,key2_hold_dur,DD_dur,UU_dur,UD_dur
1,96,80,96,80,0
1,65,56,65,56,0
1,72,72,72,72,0
1,56,64,32,40,-24
1,88,56,88,56,0
1,112,104,112,104,0
1,88,72,72,56,-16
1,88,48,88,48,0
0,120,96,72,48,-48
0,88,72,120,104,32
0,96,80,144,128,48
0,88,128,88,128,0
0,112,80,112,80,0
0,120,120,96,96,-24
0,96,72,96,72,0
0,80,80,80,80,0
0,80,81,176,177,96
0,80,96,48,64,-32
0,81,80,32,31,-49
0,99,120,19,40,-80
0,112,128,56,72,-56
0,96,101,43,48,-53
0,128,112,48,32,-80
0,96,102,42,48,-54
