uid,key1_hold_dur,key2_hold_dur,DD_dur,UU_dur,UD_dur
1,129,87,73,31,-56
1,128,61,131,64,3
1,200,128,72,0,-128
1,151,120,119,88,-32
1,135,88,127,80,-8
1,168,96,72,0,-96
1,184,120,80,16,-104
1,159,96,63,0,-96
1,136,71,81,16,-55
1,160,112,96,48,-64
1,112,111,169,168,57
1,136,136,40,40,-96
1,151,80,95,24,-56
1,128,112,200,184,72
1,176,72,104,0,-72
1,144,120,56,32,-88
1,120,71,120,71,0
1,152,120,80,48,-72
1,152,96,112,56,-40
1,135,79,136,80,1
1,128,112,88,72,-40
2,96,64,120,88,24
2,112,64,128,80,16
2,96,63,97,64,1
2,128,56,168,96,40
2,96,72,120,96,24
2,80,63,81,64,1
2,96,72,136,112,40
2,96,64,136,104,40
2,104,56,232,184,128
2,104,80,104,80,0
2,96,56,96,56,0
2,80,56,160,136,80
2,88,49,112,73,24
2,96,56,112,72,16
2,96,56,96,56,0
2,96,64,112,80,16
3,95,104,87,96,-8
3,120,120,80,80,-40
3,104,128,80,104,-24
3,136,88,120,72,-16
3,120,118,74,72,-46
3,64,104,144,184,80
3,136,112,64,40,-72
3,127,79,128,80,1
3,87,63,120,96,33
3,72,136,88,152,16
3,48,120,88,160,40
3,136,136,120,120,-16
3,96,128,96,128,0
3,96,111,97,112,1
3,120,80,120,80,0
3,104,80,104,80,0
3,96,127,97,128,1
3,112,120,112,120,0
3,119,128,191,200,72
4,64,64,160,160,96
4,80,80,120,120,40
4,64,56,112,104,48
5,136,128,136,128,0
5,160,88,208,136,48
5,120,112,112,104,-8
5,144,121,208,185,64
5,136,128,80,72,-56
5,112,104,176,168,64
5,111,128,143,160,32
5,128,120,128,120,0
5,136,128,104,96,-32
5,128,128,112,112,-16
5,144,120,888,864,744
6,64,88,88,112,24
6,88,72,128,112,40
6,104,101,161,158,57
6,104,64,136,96,32
6,128,55,129,56,1
6,126,72,126,72,0
6,88,64,88,64,0
6,96,80,88,72,-8
6,144,63,145,64,1
6,104,72,127,95,23
6,80,72,160,152,80
6,72,64,112,104,40
6,152,64,88,0,-64
7,116,88,88,60,-28
7,200,160,488,448,288
7,136,136,208,208,72
7,120,88,120,88,0
7,176,111,177,112,1
7,136,88,160,112,24
8,128,144,256,272,128
8,144,112,136,104,-8
7,200,128,88,16,-112
7,112,91,112,91,0
8,144,104,192,152,48
8,104,72,264,232,160
8,120,104,192,176,72
9,112,64,112,64,0
9,63,71,104,112,41
9,96,72,72,48,-24
10,96,136,272,312,176
10,128,72,168,112,40
10,136,152,136,152,0
10,151,128,207,184,56
10,113,128,96,111,-17
10,144,168,176,200,32
10,97,151,97,151,0
10,88,56,120,88,32
10,128,104,176,152,48
10,80,137,80,137,0
10,184,96,120,32,-64
10,112,127,113,128,1
11,80,72,160,152,80
11,56,56,136,136,80
11,72,56,72,56,0
12,88,48,88,48,0
12,72,88,96,112,24
12,79,80,111,112,32
12,88,112,184,208,96
12,80,79,80,79,0
12,88,56,120,88,32
12,73,63,129,119,56
12,112,120,184,192,72
12,80,80,80,80,0
12,80,88,136,144,56
12,79,80,95,96,16
12,96,95,96,95,0
13,103,72,671,640,568
13,24,80,776,832,752
13,152,96,80,24,-72
13,80,128,80,128,0
13,24,119,936,1031,912
13,112,88,96,72,-16
13,103,95,104,96,1
13,48,64,688,704,640
13,88,112,248,272,160
13,96,136,136,176,40
13,72,112,88,128,16
14,80,80,32,32,-48
14,96,64,96,64,0
14,104,72,104,72,0
14,96,80,96,80,0
14,72,80,72,80,0
14,81,72,56,47,-25
14,120,56,80,16,-40
14,96,24,112,40,16
14,96,104,72,80,-24
14,81,87,81,87,0
14,80,88,96,104,16
14,64,64,64,64,0
14,112,72,176,136,64
15,96,80,136,120,40
15,136,103,153,120,17
15,128,87,233,192,105
15,112,72,160,120,48
15,88,128,88,128,0
15,72,72,431,431,359
15,112,80,160,128,48
15,73,56,144,127,71
15,88,80,88,80,0
15,96,96,448,448,352
15,63,56,136,129,73
15,80,72,80,72,0
15,88,104,128,144,40
15,80,72,80,72,0
15,80,72,104,96,24
15,96,80,96,80,0
16,80,104,232,256,152
16,128,136,88,96,-40
16,104,111,105,112,1
16,88,104,112,128,24
16,87,96,127,136,40
16,95,103,96,104,1
16,96,64,120,88,24
16,104,80,72,48,-32
16,80,71,128,119,48
17,128,72,128,72,0
17,160,224,136,200,-24
17,128,80,288,240,160
17,80,80,112,112,32
17,168,152,144,128,-24
17,120,96,152,128,32
17,103,72,311,280,208
17,127,112,480,465,353
17,104,88,97,81,-7
17,136,80,776,720,640
17,80,88,120,128,40
17,176,176,160,160,-16
17,160,168,456,464,296
17,136,168,200,232,64
18,96,72,72,48,-24
18,80,88,280,288,200
18,56,72,80,96,24
18,72,80,72,80,0
18,80,80,72,72,-8
18,128,80,64,16,-64
18,88,80,88,80,0
18,80,72,96,88,16
18,80,80,112,112,32
18,104,96,40,32,-64
18,88,72,136,120,48
18,64,72,96,104,32
18,88,104,80,96,-8
18,80,64,136,120,56
19,104,88,144,128,40
19,104,96,104,96,0
19,72,72,104,104,32
19,96,104,96,104,0
19,88,97,128,137,40
19,96,96,80,80,-16
19,88,80,176,168,88
19,64,48,136,120,72
19,88,88,88,88,0
19,81,88,96,103,15
19,49,72,184,207,135
19,104,88,104,88,0
19,96,88,112,104,16
20,168,56,144,32,-24
20,123,75,124,76,1
20,138,96,114,72,-24
20,121,80,104,63,-17
20,152,72,112,32,-40
20,144,112,200,168,56
20,136,88,136,88,0
20,128,128,128,128,0
20,87,88,103,104,16
20,136,120,296,280,160
20,168,96,128,56,-40
20,136,120,136,120,0
20,160,72,128,40,-32
20,121,143,97,119,-24
20,112,80,104,72,-8
20,136,88,96,48,-40
20,144,88,104,48,-40
20,113,87,113,87,0
20,128,104,96,72,-32
20,104,88,104,88,0
20,144,88,144,88,0
20,96,80,96,80,0
20,145,136,64,55,-81
20,129,88,129,88,0
21,133,120,69,56,-64
21,137,88,201,152,64
21,136,80,216,160,80
21,112,79,113,80,1
21,176,128,80,32,-96
21,161,88,73,0,-88
21,168,95,145,72,-23
21,136,73,159,96,23
21,120,24,144,48,24
21,129,120,248,239,119
21,112,80,128,96,16
21,112,63,112,63,0
21,152,56,128,32,-24
21,128,80,176,128,48
21,96,88,120,112,24
21,112,72,136,96,24
21,88,72,112,96,24
21,128,112,80,64,-48
22,72,72,104,104,32
22,80,79,81,80,1
22,87,87,80,80,-7
22,120,96,120,96,0
22,96,96,64,64,-32
22,88,96,104,112,16
22,96,79,97,80,1
22,80,64,80,64,0
22,80,72,80,72,0
22,96,72,96,72,0
22,56,80,40,64,-16
22,80,64,104,88,24
22,72,88,64,80,-8
22,64,88,88,112,24
22,72,48,104,80,32
23,112,104,112,104,0
23,135,96,104,65,-31
23,112,64,112,64,0
23,161,96,240,175,79
23,167,47,168,48,1
23,80,80,128,128,48
23,128,112,216,200,88
23,160,104,288,232,128
23,96,80,752,736,656
24,144,72,128,56,-16
24,136,64,136,64,0
24,160,40,224,104,64
24,169,88,81,0,-88
24,160,94,234,168,74
24,152,64,152,64,0
25,72,88,104,120,32
25,64,80,112,128,48
25,112,64,168,120,56
25,96,104,88,96,-8
26,96,81,88,73,-8
26,80,89,96,105,16
26,105,95,65,55,-40
26,152,72,96,16,-56
26,136,104,136,104,0
26,136,72,592,528,456
26,112,72,112,72,0
26,88,96,88,96,0
26,88,72,88,72,0
26,143,119,88,64,-55
26,95,96,151,152,56
27,160,72,256,168,96
28,56,88,231,263,175
28,63,71,128,136,65
28,72,64,112,104,40
28,112,72,144,104,32
28,56,80,136,160,80
28,56,80,128,152,72
28,136,112,496,472,360
28,56,72,120,136,64
28,79,72,183,176,104
28,80,80,152,152,72
28,88,56,400,368,312
28,72,72,120,120,48
28,80,88,184,192,104
28,80,72,128,120,48
29,152,88,440,376,288
29,208,128,120,40,-88
29,208,120,104,16,-104
29,208,111,129,32,-79
29,176,96,128,48,-48
29,208,88,168,48,-40
29,232,89,144,1,-88
29,240,121,120,1,-120
30,88,80,584,576,496
30,80,72,152,144,72
30,120,80,112,72,-8
30,95,64,151,120,56
30,103,64,127,88,24
30,96,56,144,104,48
30,56,56,152,152,96
30,72,72,168,168,96
